Панели каталогов

Tab, Ctrl + i	сменить текущую (активную) панель
Insert, Ctrl + t	отметить файл либо снять отметку
Alt + a вывод рабочего каталога в консоль
Alt + Enter вывод имени выбранного файла в консоль
Alt + g,
Alt + r,
Alt + j	подсветка верхнего, среднего или нижнего файла из числа отображаемых на панели
Alt + t	переключить режим отображения
Ctrl + \	показать «Справочник каталогов»
+	выбрать (отметить) группу файлов по регулярному выражению
\	снять отметку с группы файлов
Alt + o	если выделен каталог, установить его текущим в неактивной панели. Иначе, установить родительский каталог текущим.
Alt + i	текущий каталог активной панели станет текущим каталогом неактивной панели
Alt + y	к предыдущему каталогу из истории перемещения
Alt + u	к следующему каталогу из истории перемещения
Alt + H	отображает историю перемещения по каталогам
Alt + e	поменять кодировку панели
Alt + .	отобразить скрытые файлы
Alt + ,	расположить панели вертикально/горизонтально
Ctrl + u	поменять панели местами


Разные команды

Ctrl + x c	поменять права (chmod)для отмеченных файлов
Ctrl + x o	поменять владельца (chown)для отмеченных файлов
Ctrl + x l	создать жёсткую ссылку
Ctrl + x s	создать абсолютную символическую ссылку
Ctrl + x v	создать относительную символическую ссылку
Ctrl + x i	переводит пассивную панель в режим «Информация»
Ctrl + x q	переводит пассивную панель в режим быстрого просмотра
Ctrl + x !	меню → «Критерий панелизации»
Ctrl + x h	добавить имя каталога в «Справочник каталогов»
Alt + !	просмотр вывода команды
Ctrl + Space	подсчёт размера каталога
Alt + c	окно «Быстрая смена каталога»
Ctrl + o	скрыть/показать панели
Ctrl + l	перерисовать экран
Ctrl + r	перечитать содержимое каталога
Shift + F6	переименовать файл
Ctrl + x j	показать фоновые задания
Ctrl + x d	сравнить каталоги
Ctrl + x,
Ctrl + d	сравнить файлы
Alt + ?	окно «Поиск файла»


Быстрый поиск

Ctrl/Alt + s	режим быстрого поиска


Командная строка оболочки

Ctrl/Alt + Enter	копирует подсвеченное имя файла в командную строку
Alt + Tab	пытается выполнить операцию Завершение ввода
Ctrl + x t,
Ctrl + x
Ctrl + t	копирует в командную строку имена помеченных файлов из активной/пассивной панели
Ctrl + x p,
Ctrl + x
Ctrl + p	копирует в командную строку имя текущего каталога из активной/пассивной панели
Ctrl + q	вставить символы, которые интерпретируются mc (пример: +)
Alt + p,
Alt + n	перемещение по истории команд
Alt + h	выводит историю текущей строки ввода (историю команд)
Ctrl + V	вставка из буфера обмена
